alewando=Adam Lewandowski <adam@alewando.com>
allena28=Adam Allen <adam@dynamicinteraction.co.uk>
atirc=Alberto González Rodríguez <alberto@pesadilla.org>
attila_nagy=Attila Nagy <nagy.attila.gabor@gmail.com>
axis3x3=Andy Balaam <andybalaam@artificialworlds.net>
b4max=Max Becker <maxbecker@rocketmail.com>
betlit=Daniel Bittel <betlit@gmx.net>
bhaak=Patric Mueller <bhaak@gmx.net>
bilbo_uk=Geoff Westcott <honir999@gmail.com>
candu_sf=Chris Owen <c_g_owen@hotmail.com>
car_unlp=Christian A. Rodriguez <car@cespi.unlp.edu.ar>
christianw=Christian Wattengård <cwattengard@gmail.com>
chunkygoodness=Andre Renaud <andre.renaud@hp.com>
cpicton=Chris Picton <chrisp@tangent.co.za>
crispygoth=Chris Butler <chrisb@debian.org>
dekarl=Karl Dietz <dekarl@spaetfruehstuecken.org>
dubman=Mike Dubman <mike.dubman@gmail.com>
eborn=Eric Bus <mail@ilovelinda.nl>
ecastelnau=Eric Castelnau <eric.castelnau@free.fr>
eggertthor=Eggert Thorlacius <eggert@thorlacius.com>
epaepa=Ed Avis <ed@membled.com>
fgouget=Francois Gouget <fgouget@free.fr>
gawen=Bruno Tavares <gawen@users.sourceforge.net>
gtb=Gary Buhrmaster <gary.buhrmaster@gmail.com>
igitur=Francois Botha <igitur@gmail.com>
jskov=Jesper Skov <jskov@zoftcorp.dk>
jtoft=Jesper Toft <jesper@bzimage.dk>
jveldhuis=Jerry Veldhuis <jerry@matilda.com>
kgroeneveld1=Kevin Groeneveld <kgroeneveld@gmail.com>
knowledgejunkie=Nick Morrott <knowledgejunkie@gmail.com>
komoriya=Takeru Komoriya <komoriya@paken.org>
lightpriest=Or Cohen <or.cohen007@gmail.com>
ma_begaj=Ma Begaj <derliebegott@gmail.com>
marianok=Mariano Cosentino <4XMLTV@marianok.com.ar>
mattiasholmlund=Mattias Holmlund <u82@m1.holmlund.se>
mbdev=Balazs Molnar <mbdev@freemail.hu>
mihaas=Michael Haas <laga+xmltv@laga.ath.cx>
mnbjhguyt=Davide Chiarini <davide.chiarini@gmail.com>
mtoledo=Marcelo Toledo <marcelo@marcelotoledo.org>
ngarratt=Neil Garratt <ngarratt@gmail.com>
nielm=Niel Markwick <nielm@bigfoot.com>
perlundberg=Per Lundberg <perlun@gmail.com>
pingel=Søren Pingel Dalsgaard <soren@dalsgaards.dk>
pronovic=Kenneth Pronovici <pronovic@skyjammer.com>
ramonroca=Ramon Roca <Ramon.Roca@XCombo.com>
reudeudeu=Sylvain Fabre <centraladmin@lahiette.com>
rmeden=Robert Eden <rmeden@gmail.com>
staffanmalmgren=Staffan Malmgren <staffan@tomtebo.org>
stefanb2=Stefan Becker <chemobejk@gmail.com>
stesie=Stefan Siegl <stesie@brokenpipe.de>
sunsetsystems=Rod Roark <rod@sunsetsystems.com>
thh=Thomas Horsten <thomas@horsten.com>
va1210=Ville Ahonen <ville-xmltv@thesubmachine.com>
yunosh=Jan Schneider <jan@horde.org>
zcougar=Cougar <xmltv@lost.data.ee>
runner_test
